      |      |      |H     
      |      |      |      
      |      |      |      
      |      |      |      
______T______T______T______
      |      |      |      
      |      |      |      
      |      |      |      
      |      |      |      
______T______T______T______
      |      |      |      
      |      |      |      
      |      |      |      
      |      |      |      
______T______T______T______
      |      |      |      
      |      |      |      
      |      |      |      
      |      |      |      